Room,Capacity,From,To,oc
101,4,0,0,0
102,8,0,0,0
103,4,0,0,0
201,4,0,0,0
202,10,0,0,0
203,6,0,0,0
301,4,0,0,0
302,6,0,0,0
303,8,0,0,0
401,22,0,0,0
